"VIN","奖金","储备金","合计","车型","价格","配置","CALL车日期","开票日期","发票号"
"LSGKB5412LV060635",-24000,-86304,-110304,"科鲁泽",114900,"科鲁泽 RS 330T自动 畅快版 20","2019-12-09","2019/12/9 0:00","3118295267"
"LSGZG539XKS114674",-9000,-149304,-158304,"迈锐宝XL",164900,"全新迈锐宝XL 535T 锐动版(B-SRF)(Black) 19","2019-12-09","2019/12/9 0:00","3118295271"
"LSGZG5398KS116603",-9000,-149304,-158304,"迈锐宝XL",164900,"全新迈锐宝XL 535T 锐动版(B-SRF)(Black) 19","2019-12-09","2019/12/9 0:00","3118295273"
"LSGZG5393KS115679",-9000,-149304,-158304,"迈锐宝XL",164900,"全新迈锐宝XL 535T 锐动版(B-SRF)(Black) 19","2019-12-09","2019/12/9 0:00","3118295272"
"LSGKB5410LV060858",-9000,-101304,-110304,"科鲁泽",114900,"科鲁泽 RS 330T自动 畅快版 20","2019-12-09","2019/12/9 0:00","3118295268"
"LSGKB5417LV060758",-9000,-101304,-110304,"科鲁泽",114900,"科鲁泽 RS 330T自动 畅快版 20","2019-12-09","2019/12/9 0:00","3118295270"
"LSGKB5419LV064679",-9000,-101304,-110304,"科鲁泽",114900,"科鲁泽 RS 330T自动 畅快版 20","2019-12-09","2019/12/9 0:00","3118295264"
"LSGKB5410LV064733",-9000,-101304,-110304,"科鲁泽",114900,"科鲁泽 RS 330T自动 畅快版 20","2019-12-09","2019/12/9 0:00","3118295263"
"LSGKB5418LV060655",-9000,-101304,-110304,"科鲁泽",114900,"科鲁泽 RS 330T自动 畅快版 20","2019-12-09","2019/12/9 0:00","3118295266"
"LSGKB5413LV060580",-9000,-101304,-110304,"科鲁泽",114900,"科鲁泽 RS 330T自动 畅快版 20","2019-12-09","2019/12/9 0:00","3118295269"
"LSGKB5419LV060857",-9000,-101304,-110304,"科鲁泽",114900,"科鲁泽 RS 330T自动 畅快版 20","2019-12-09","2019/12/9 0:00","3118295265"
"LSGEN54A8LD121111",-9000,-77304,-86304,"科沃兹",89900,"新科沃兹 325T自动欣悦版(BT)(GB6) 20","2019-12-11","2019/12/11 0:00","3118301179"
"LSGTN8396LY019217",-101940,-61164,-163104,"创界",169900,"创界 435T RS CVT劲锐版(黑顶)(B-SRF) 20","2019-12-27","2019/12/27","3118363024"
"LSGTN8392LY015469",-107940,-64764,-172704,"创界",179900,"创界 435T RS 9AT悍锐版(黑顶) 20","2019-12-30","2019/12/30","3118372832"
"LSGXC83L5KV434757",-135540,-81324,-216864,"探界者",225900,"探界者 550T 9速 四驱拓界版Base(Black)(RS&redline)(Liftgate)(GB6) 19.5","2020-01-06","2020/1/6","3118408645"
"LSGXC835XKV427241",-119940,-71964,-191904,"探界者",199900,"探界者 535T 驭界版(Black)(Liftgate)(GB6) 19.5","2020-01-06","2020/1/6","3118408646"
"LSGXC8356KV427155",-119940,-71964,-191904,"探界者",199900,"探界者 535T 驭界版(Black)(Liftgate)(GB6) 19.5","2020-01-06","2020/1/6","3118408647"
"LSGKH8410KY067290",-89940,-53964,-143904,"沃兰多",149900,"沃兰多 Redline 530T 自动纵享版(7Seat)(PU&Bt)(GB6) 19.5","2020-01-06","2020/1/6","3118408642"
"LSGKH8410KY069010",-89940,-53964,-143904,"沃兰多",149900,"沃兰多 Redline 530T 自动纵享版(7Seat)(PU&Bt)(GB6) 19.5","2020-01-06","2020/1/6","3118408644"
"LSGKH8419KY067207",-89940,-53964,-143904,"沃兰多",149900,"沃兰多 Redline 530T 自动纵享版(7Seat)(PU&Bt)(GB6) 19.5","2020-01-06","2020/1/6","3118408643"
"LSGZG53L5KS121074",-122940,-73764,-196704,"迈锐宝XL",204900,"全新迈锐宝XL 550T 锐联版(B-SRF)(redline) 19","2020-01-09","2020/1/9","3118418997"
"LSGZG53L4KS121034",-122940,-73764,-196704,"迈锐宝XL",204900,"全新迈锐宝XL 550T 锐联版(B-SRF)(redline) 19","2020-01-09","2020/1/9","3118418998"
"LSGZG53L8KS120758",-11000,-185704,-196704,"迈锐宝XL",204900,"全新迈锐宝XL 550T 锐联版(B-SRF)(redline) 19","2020-01-09","2020/1/9","3118418996"
"LSGZG53L4KS124936",-44178,-152526,-196704,"迈锐宝XL",204900,"全新迈锐宝XL 550T 锐联版(B-SRF)(redline) 19","2020-01-12","2020/1/12","3118425035"
"LSGZG53L9KS124804",-122940,-73764,-196704,"迈锐宝XL",204900,"全新迈锐宝XL 550T 锐联版(B-SRF)(redline) 19","2020-01-12","2020/1/12","3118425034"
"LSGKB5417LV076961",-9000,-106104,-115104,"科鲁泽",119900,"科鲁泽 RS 330T自动 痛快版 20","2020-01-13","2020/1/13","3118428840"
"LSGKB5413LV078996",-9000,-101304,-110304,"科鲁泽",114900,"科鲁泽 RS 330T自动 畅快版 20","2020-01-13","2020/1/13","3118428838"
"LSGKB5417LV078838",-9000,-101304,-110304,"科鲁泽",114900,"科鲁泽 RS 330T自动 畅快版 20","2020-01-13","2020/1/13","3118428839"
"LSGXC83L3KV432666",-15000,-201864,-216864,"探界者",225900,"探界者 550T 9速 四驱拓界版Base(Black)(RS&redline)(Liftgate)(GB6) 19.5","2020-01-13","2020/1/13","3118428842"
"LSGKH8418KY065156",-7000,-127304,-134304,"沃兰多",139900,"沃兰多 530T 自动劲享版(7Seat)(SRF)(GB6) 19.5","2020-01-13","2020/1/13","3118428836"
"LSGKH8414KY067051",-7000,-136904,-143904,"沃兰多",149900,"沃兰多 Redline 530T 自动纵享版(7Seat)(PU&Bt)(GB6) 19.5","2020-01-13","2020/1/13","3118428837"
"LSGXC8350KV434859",-10000,-172304,-182304,"探界者",189900,"探界者 535T 驰界版(Black)(SRF)(leather)(GB6) 19.5","2020-01-13","2020/1/13","3118428841"